#############################################################
######                    ########################    #######
#  ##   ################          #       ###      ##  ##   #
##    ####          ########## #### #####  ##### #####    ###
## #####   #######                    ##  ###    ##  ### ####
#  ##    ###   ################# ###  #  ###  ####    ##  ###
# # ## ###   #   ###      ###     ## ## ###  ##    ##  ##  ##
# # #  ##  #####     #### ### ###  ###      ##########  ##  #
#   # ##  ##  ## ##### ## ##   ##  ### #######      ### ### #
## ## ###    ### ###   ##    # ## ###  ##      ####     ### #
#  ##  #######     # #  ### ####  ##  ##  ########E ####### #
## ###  ###    ##### ## ######   ### ### ##   ###     ###   #
##   ##     #####    ##        ####    #  ###  ######    # ##
#  #  ########    #######  ## ###### # ## ####    ##### ## ##
###  ###       #####      ##     ##### ##  ###### ##  #    ##
#   ##   #######     ############### #  ##   #$## ## ### ####
# # ## ###   #######       ##    ### ##  # ###  # ## ##### ##
# # ##  ## #     #########   ##      #  #  ##  ## #    #    #
#   ### ### +##          ####   # ## ## # ##   ## ####   # ##
## ####     ############      #####  ## #    ###       ###  #
##  ##########        ##########    ##  ######   ######### ##
###  ## # #    #####             ## ###        ### ###     ##
####         ###     #############   #############     ######
#############################################################

