###############################
#  #          #     ## #      #
# ## ### ### #### #  # # # ## #
#  ##  # ##   # # ##   #   #  #
##  ## #    #     ### ## ### ##
# # #    #  # ###  #  #  # #  #
# #  # ######## #####    # ## #
# E        ##+     #####   ## #
#   ## ###  ## # ###   ### #  #
# # #                #   # #$ #
###############################
